11111111111111111111111111111
14000000000000000000000000041
10101010101010101010101010101
10101010101010101010101010101
10101010101010101010101010101
10101010101010101010101010101
10101010101010101010101010101
10000000000000000000000000001
10111111110111211101111111101
101000000001g333g100000000101
104000000101g333g101000000401
10111111110111111101111111101
10000000000000000000000000001
10101010101010101010101010101
10101010101010101010101010101
10101010101010101010101010101
10101010101010101010101010101
10101010101010101010101010101
14000000000000p00000000000041
11111111111111111111111111111

0 ball
1 wall
2 gate          (only one)
p pacman        (only one)
g ghost         (only four)
3 blank
4 power ball
